##########.....######
#....###......#######
#....#....#.#######......
#..###@..####.....#...
#..##.......##...###..#
#.....####....##....###
#....####..##.###...##
#####.....####.#.###.#