R____________L
H__]....,....H
H______]%[___H
H.....P.....,H
H__________]OH
H.,....,....OH
H_%____%____%H
H.,.[_]..,...H
H_%______O___H
H....,.[_O___H
H____%___%..,H
H......#.....H
>____________<